huy	h u y
nam	n a m
hóa	h ó a
bố	b ố
chồng	c h ồ n g
xì	x ì
tin	t i n
đối	đ ố i
thoại	t h o ạ i
bá	b á
đạo	đ ạ o
với	v ớ i
con	c o n
dâu	d â u
hải	h ả i
yến	y ế n
chất	c h ấ t
nhờn	n h ờ n
này	n à y
có	c ó
tác	t á c
dụng	d ụ n g
giúp	g i ú p
bôi	b ô i
trơn	t r ơ n
tránh	t r á n h
đau	đ a u
rát	r á t
để	đ ể
được	đ ư ợ c
trải	t r ả i
nghiệm	n g h i ệ m
cảm	c ả m
giác	g i á c
thoải	t h o ả i
mái	m á i
và	v à
rinh	r i n h
qua	q u a
tặng	t ặ n g
nào	n à o
đây	đ â y
chính	c h í n h
là	l à
cách	c á c h
thai	t h a i
hiệu	h i ệ u
quả	q u ả
nhất	n h ấ t
mà	m à
không	k h ô n g
cần	c ầ n
sử	s ử
bao	b a o
cao	c a o
su	s u
cặp	c ặ p
đôi	đ ô i
cũng	c ũ n g
biết	b i ế t
sở	s ở
tài	t à i
tỉnh	t ỉ n h
bình	b ì n h
dương	d ư ơ n g
đang	đ a n g
phối	p h ố i
hợp	h ợ p
xây	x â y
dựng	d ự n g
thông	t h ô n g
quy	q u y
hoạch	h o ạ c h
đất	đ ấ t
của	c ủ a
nhiều	n h i ề u
trụ	t r ụ
công	c ô n g
còn	c ò n
lại	l ạ i
tiếp	t i ế p
tục	t ụ c
bán	b á n
đấu	đ ấ u
giá	g i á
nhưng	n h ư n g
những	n h ữ n g
đứa	đ ứ a
trẻ	t r ẻ
phải	p h ả i
mang	m a n g
trong	t r o n g
mình	m ì n h
giọt	g i ọ t
máu	m á u
tượng	t ư ợ n g
xâm	x â m
hại	h ạ i
thì	t h ì
thực	t h ự c
sự	s ự
cay	c a y
đắng	đ ắ n g
cùng	c ù n g
họ	h ọ
người	n g ư ờ i
mê	m ê
dòng	d ò n g
gốm	g ố m
mỹ	m ỹ
thiện	t h i ệ n
đầy	đ ầ y
sáng	s á n g
tạo	t ạ o
tìm	t ì m
đến	đ ế n
ông	ô n g
thiết	t h i ế t
kế	k ế
tiêu	t i ê u
bản	b ả n
khác	k h á c
nhau	n h a u
đặt	đ ặ t
hàng	h à n g
làm	l à m
thỉnh	t h ỉ n h
thoảng	t h o ả n g
dùng	d ù n g
bàn	b à n
tay	t a y
mạnh	m ạ n h
mẽ	m ẽ
đảo	đ ả o
thịt	t h ị t
từ	t ừ
dưới	d ư ớ i
lên	l ê n
trên	t r ê n
miếng	m i ế n g
bóng	b ó n g
mượt	m ư ợ t
nhìn	n h ì n
đã	đ ã
sẽ	s ẽ
ngon	n g o n
rồi	r ồ i
sao	s a o
thức	t h ứ c
ăn	ă n
đủ	đ ủ
dinh	d i n h
dưỡng	d ư ỡ n g
đồng	đ ồ n g
thời	t h ờ i
khi	k h i
chế	c h ế
biến	b i ế n
mùi	m ù i
khói	k h ó i
độc	đ ộ c
ảnh	ả n h
hưởng	h ư ở n g
sức	s ứ c
khỏe	k h ỏ e
cả	c ả
gia	g i a
đình	đ ì n h
nhận	n h ậ n
đám	đ á m
tiệc	t i ệ c
cưới	c ư ớ i
hỏi	h ỏ i
gần	g ầ n
xa	x a
luôn	l u ô n
mẫu	m ẫ u
xe	x e
hoa	h o a
đời	đ ờ i
mới	m ớ i
hà	h à
nội	n ộ i
lấy	l ấ y
ý	ý
kiến	k i ế n
về	v ề
việc	v i ệ c
chặt	c h ặ t
hạ	h ạ
thay	t h a y
thế	t h ế
toàn	t o à n
bộ	b ộ
cây	c â y
xà	x à
cừ	c ừ
vi	v i
đi	đ i
cường	c ư ờ n g
đô	đ ô
la	l a
xóa	x ó a
tan	t a n
nghi	n g h i
án	á n
đường	đ ư ờ n g
ai	a i
nấy	n ấ y
mỗi	m ỗ i
chúng	c h ú n g
ta	t a
đều	đ ề u
một	m ộ t
điều	đ i ề u
gì	g ì
đó	đ ó
cho	c h o
giới	g i ớ i
khả	k h ả
năng	n ă n g
nhanh	n h a n h
chóng	c h ó n g
đánh	đ á n h
hơi	h ơ i
giả	g i ả
cơ	c ơ
quan	q u a n
xử	x ử
lý	l ý
hồ	h ồ
sơ	s ơ
đăng	đ ă n g
ký	k ý
nhãn	n h ã n
tại	t ạ i
việt	v i ệ t
chí	c h í
lựa	l ự a
chọn	c h ọ n
địa	đ ị a
chỉ	c h ỉ
niềng	n i ề n g
răng	r ă n g
uy	u y
tín	t í n
ở	ở
sài	s à i
gòn	g ò n
xương	x ư ơ n g
bệnh	b ệ n h
miệng	m i ệ n g
hề	h ề
hiếm	h i ế m
gặp	g ặ p
đáng	đ á n g
tự	t ự
hào	h à o
món	m ó n
phở	p h ở
bò	b ò
mặt	m ặ t
vị	v ị
trí	t r í
đầu	đ ầ u
danh	d a n h
sách	s á c h
linh	l i n h
đại	đ ạ i
sứ	s ứ
chiến	c h i ế n
dịch	d ị c h
đội	đ ộ i
mũ	m ũ
bảo	b ả o
hiểm	h i ể m
chủ	c h ủ
tịch	t ị c h
thái	t h á i
sơn	s ơ n
trần	t r ầ n
anh	a n h
tú	t ú
trưởng	t r ư ở n g
văn	v ă n
vũ	v ũ
thất	t h ấ t
tình	t ì n h
lẽ	l ẽ
tồi	t ồ i
tệ	t ệ
từng	t ừ n g
bị	b ị
phát	p h á t
hiện	h i ệ n
giống	g i ố n g
hệt	h ệ t
gốc	g ố c
chi	c h i
tiết	t i ế t
nhỏ	n h ỏ
chuyện	c h u y ệ n
xảy	x ả y
ra	r a
đột	đ ộ t
ngột	n g ộ t
dọa	d ọ a
sợ	s ợ
hết	h ế t
mọi	m ọ i
tô	t ô
mộ	m ộ
tới	t ớ i
mức	m ứ c
hô	h ô
lớn	l ớ n
kêu	k ê u
gọi	g ọ i
y	y
loạt	l o ạ t
nghị	n g h ị
đổ	đ ổ
vốn	v ố n
tỷ	t ỷ
usd	u s d
vào	v à o
sau	s a u
vay	v a y
tiền	t i ề n
vợ	v ợ
lẩn	l ẩ n
trả	t r ả
tóc	t ó c
hậu	h ậ u
thu	t h u
hoài	h o à i
nghệ	n g h ệ
sĩ	s ĩ
trang	t r a n g
phục	p h ụ c
trắng	t r ắ n g
tham	t h a m
dự	d ự
do	d o
sàn	s à n
ngoài	n g o à i
trời	t r ờ i
độ	đ ộ
bền	b ề n
thẩm	t h ẩ m
đẹp	đ ẹ p
thi	t h i
các	c á c
hạng	h ạ n g
mục	m ụ c
trình	t r ì n h
nó	n ó
tiên	t i ê n
cô	c ô
gái	g á i
lãng	l ã n g
mạn	m ạ n
dịu	d ị u
dàng	d à n g
nữ	n ữ
tính	t í n h
màu	m à u
thấy	t h ấ y
giữa	g i ữ a
hai	h a i
lông	l ô n g
mày	m à y
thường	t h ư ờ n g
phổi	p h ổ i
nỗi	n ỗ i
buồn	b u ồ n
rõ	r õ
khuôn	k h u ô n
dân	d â n
nơi	n ơ i
góc	g ó c
phòng	p h ò n g
bày	b à y
thú	t h ú
bông	b ô n g
bạn	b ạ n
bè	b è
hâm	h â m
ngọc	n g ọ c
hân	h â n
yêu	y ê u
thích	t h í c h
thử	t h ử
thách	t h á c h
tù	t ù
tá	t á
ngày	n g à y
đọc	đ ọ c
hiểu	h i ể u
áp	á p
nguyên	n g u y ê n
tắc	t ắ c
tiễn	t i ễ n
giàu	g i à u
nay	n a y
đơn	đ ơ n
giản	g i ả n
đặc	đ ặ c
biệt	b i ệ t
kiếm	k i ế m
hội	h ộ i
đưa	đ ư a
sản	s ả n
phẩm	p h ẩ m
trà	t r à
vả	v ả
nước	n ư ớ c
máy	m á y
lạnh	l ạ n h
thảm	t h ả m
lót	l ó t
hệ	h ệ
thống	t h ố n g
chiếu	c h i ế u
kiệm	k i ệ m
điện	đ i ệ n
thâm	t h â m
hơn	h ơ n
thạch	t h ạ c h
viết	v i ế t
bức	b ứ c
thư	t h ư
đề	đ ề
tên	t ê n
cảnh	c ả n h
sát	s á t
khu	k h u
vực	v ự c
nhằm	n h ằ m
đe	đ e
bà	b à
cơn	c ơ n
nhức	n h ứ c
xuất	x u ấ t
thoái	t h o á i
cột	c ộ t
sống	s ố n g
yếu	y ế u
trạng	t r ạ n g
viêm	v i ê m
lần	l ầ n
trường	t r ư ờ n g
tôi	t ô i
giáo	g i á o
viên	v i ê n
đua	đ u a
trái	t r á i
ngược	n g ư ợ c
ê	ê
kíp	k í p
phim	p h i m
hùng	h ù n g
dàn	d à n
diễn	d i ễ n
cha	c h a
cõng	c õ n g
gương	g ư ơ n g
ngang	n g a n g
khai	k h a i
thiếu	t h i ế u
nợ	n ợ
nên	n ê n
gây	g â y
vụ	v ụ
cướp	c ư ớ p
giờ	g i ờ
sóng	s ó n g
gió	g i ó
thùy	t h ù y
chút	c h ú t
nghĩ	n g h ĩ
ngợi	n g ợ i
lầm	l ầ m
cũ	c ũ
chú	c h ú
vì	v ì
ngoại	n g o ạ i
hình	h ì n h
nóng	n ó n g
bỏng	b ỏ n g
hộ	h ộ
tranh	t r a n h
luận	l u ậ n
chiều	c h i ề u
trước	t r ư ớ c
hành	h à n h
động	đ ộ n g
chức	c h ứ c
cuộc	c u ộ c
kịp	k ị p
ngăn	n g ă n
chặn	c h ặ n
chuyên	c h u y ê n
cung	c u n g
cấp	c ấ p
loại	l o ạ i
nhôm	n h ô m
thanh	t h a n h
định	đ ị n h
theo	t h e o
tiến	t i ế n
nghĩa	n g h ĩ a
hằng	h ằ n g
thành	t h à n h
nổi	n ổ i
tiếng	t i ế n g
chung	c h u n g
bật	b ậ t
phút	p h ú t
chót	c h ó t
nói	n ó i
ba	b a
vậy	v ậ y
vệ	v ệ
bỏ	b ỏ
chạy	c h ạ y
đàn	đ à n
vẫn	v ẫ n
cầm	c ầ m
dao	d a o
đuổi	đ u ổ i
đâm	đ â m
nhát	n h á t
vùng	v ù n g
ngực	n g ự c
cổ	c ổ
khiến	k h i ế n
nạn	n ạ n
nhân	n h â n
gục	g ụ c
chỗ	c h ỗ
mặc	m ặ c
chiếc	c h i ế c
áo	á o
phông	p h ô n g
xanh	x a n h
nhạt	n h ạ t
quần	q u ầ n
dài	d à i
be	b e
đeo	đ e o
kính	k í n h
mát	m á t
quen	q u e n
thuộc	t h u ộ c
viện	v i ệ n
sắm	s ắ m
may	m a y
như	n h ư
bằng	b ằ n g
chứng	c h ứ n g
ngờ	n g ờ
bí	b í
mật	m ậ t
hẹn	h ẹ n
hò	h ò
cư	c ư
mạng	m ạ n g
tinh	t i n h
phụ	p h ụ
càng	c à n g
nặng	n ặ n g
biểu	b i ể u
huyết	h u y ế t
chưa	c h ư a
buộc	b u ộ c
phẫu	p h ẫ u
thuật	t h u ậ t
cứu	c ứ u
loan	l o a n
dung	d u n g
đuối	đ u ố i
khiêm	k h i ê m
nhường	n h ư ờ n g
lành	l à n h
hầu	h ầ u
cố	c ố
tra	t r a
giật	g i ậ t
tông	t ô n g
hồng	h ồ n g
cánh	c á n h
trở	t r ở
thật	t h ậ t
hấp	h ấ p
dẫn	d ẫ n
tuy	t u y
nhiên	n h i ê n
rằng	r ằ n g
muốn	m u ố n
thêm	t h ê m
nhắm	n h ắ m
ty	t y
triều	t r i ề u
đen	đ e n
kinh	k i n h
doanh	d o a n h
ngả	n g ả
trung	t r u n g
quốc	q u ố c
sông	s ô n g
long	l o n g
nghiệp	n g h i ệ p
dây	d â y
kê	k ê
lập	l ậ p
chòi	c h ò i
lợi	l ợ i
bất	b ấ t
hút	h ú t
cát	c á t
lậu	l ậ u
nghiên	n g h i ê n
nhà	n h à
khoa	k h o a
học	h ọ c
da	d a
lão	l ã o
hoá	h o á
tố	t ố
khí	k h í
dầu	d ầ u
thuốc	t h u ố c
lá	l á
tử	t ử
thơm	t h ơ m
điểm	đ i ể m
lễ	l ễ
diện	d i ệ n
đồ	đ ồ
bơi	b ơ i
trượt	t r ư ợ t
tuyết	t u y ế t
chấp	c h ấ p
chỉn	c h ỉ n
chu	c h u
đắt	đ ắ t
đỏ	đ ỏ
kiện	k i ệ n
nhã	n h ã
giải	g i ả i
tỏa	t ỏ a
xúc	x ú c
làn	l à n
mịn	m ị n
màng	m à n g
môn	m ô n
lịch	l ị c h
gũi	g ũ i
thắp	t h ắ p
niềm	n i ề m
hứng	h ứ n g
đam	đ a m
em	e m
sinh	s i n h
phương	p h ư ơ n g
mai	m a i
táo	t á o
bạo	b ạ o
đầm	đ ầ m
cắt	c ắ t
xẻ	x ẻ
duy	d u y
trì	t r ì
sạch	s ạ c h
rửa	r ử a
xuyên	x u y ê n
hoặc	h o ặ c
đái	đ á i
dầm	d ầ m
nhuộm	n h u ộ m
cầu	c ầ u
kỳ	k ỳ
truyền	t r u y ề n
ngắn	n g ắ n
bổ	b ổ
luống	l u ố n g
trào	t r à o
lưu	l ư u
đoạn	đ o ạ n
sốc	s ố c
thủ	t h ủ
báo	b á o
phanh	p h a n h
phui	p h u i
ép	é p
nghỉ	n g h ỉ
ghen	g h e n
mẹ	m ẹ
hé	h é
lộ	l ộ
gay	g a y
cấn	c ấ n
ngân	n g â n
ts	t s
hôm	h ô m
bước	b ư ớ c
lãnh	l ã n h
suốt	s u ố t
nữa	n ữ a
hồn	h ồ n
tộc	t ộ c
xế	x ế
lơ	l ơ
mỏi	m ỏ i
mệt	m ệ t
huống	h u ố n g
xấu	x ấ u
thể	t h ể
tường	t ư ờ n g
sửa	s ử a
đổi	đ ổ i
đích	đ í c h
vui	v u i
chơi	c h ơ i
vương	v ư ơ n g
quán	q u á n
rất	r ấ t
hỗn	h ỗ n
cực	c ự c
mã	m ã
giỏi	g i ỏ i
bởi	b ở i
lắm	l ắ m
gớm	g ớ m
phân	p h â n
đệ	đ ệ
khớp	k h ớ p
căn	c ă n
phổ	p h ổ
lúc	l ú c
sắp	s ắ p
xịt	x ị t
chân	c h â n
mất	m ấ t
chương	c h ư ơ n g
năm	n ă m
lửa	l ử a
ban	b a n
nhạc	n h ạ c
thân	t h â n
nửa	n ử a
kia	k i a
mua	m u a
ủng	ủ n g
thải	t h ả i
vấn	v ấ n
tối	t ố i
tầm	t ầ m
đông	đ ô n g
đèn	đ è n
pha	p h a
ngẫm	n g ẫ m
quyền	q u y ề n
lộc	l ộ c
tật	t ậ t
chị	c h ị
ngại	n g ạ i
cứ	c ứ
đứng	đ ứ n g
quỹ	q u ỹ
dễ	d ễ
minh	m i n h
nguyệt	n g u y ệ t
đóng	đ ó n g
góp	g ó p
kể	k ể
tuyển	t u y ể n
chuyến	c h u y ế n
ấy	ấ y
lực	l ự c
tam	t a m
che	c h e
tròn	t r ò n
tháp	t h á p
lục	l ụ c
lăng	l ă n g
bát	b á t
di	d i
hạnh	h ạ n h
nhi	n h i
vịnh	v ị n h
gửi	g ử i
vòng	v ò n g
chia	c h i a
thập	t h ậ p
ác	á c
bại	b ạ i
hoàn	h o à n
trống	t r ố n g
giám	g i á m
khách	k h á c h
lật	l ậ t
đêm	đ ê m
lào	l à o
in	i n
đoàn	đ o à n
tàu	t à u
dừng	d ừ n g
hẳn	h ẳ n
bụi	b ụ i
bẩn	b ẩ n
tạp	t ạ p
bã	b ã
thừa	t h ừ a
tận	t ậ n
sâu	s â u
lỗ	l ỗ
khô	k h ô
chợ	c h ợ
rẽ	r ẽ
xã	x ã
cam	c a m
tuyên	t u y ê n
kẹo	k ẹ o
dụ	d ụ
dỗ	d ỗ
du	d u
dã	d ã
trai	t r a i
đớn	đ ớ n
khối	k h ố i
não	n ã o
bác	b á c
sỹ	s ỹ
họng	h ọ n g
ly	l y
gầm	g ầ m
nhẹ	n h ẹ
ôm	ô m
nụ	n ụ
hôn	h ô n
nhiệt	n h i ệ t
xưng	x ư n g
ngũ	n g ũ
lương	l ư ơ n g
tướng	t ư ớ n g
trương	t r ư ơ n g
liêu	l i ê u
vu	v u
cấm	c ấ m
cáp	c á p
hoảng	h o ả n g
tháng	t h á n g
trị	t r ị
sang	s a n g
thương	t h ư ơ n g
bé	b é
khống	k h ố n g
sẵn	s ẵ n
sàng	s à n g
ngõ	n g õ
ô	ô
phố	p h ố
hoàng	h o à n g
thám	t h á m
tốt	t ố t
thắt	t h ắ t
lưng	l ư n g
lâu	l â u
trọng	t r ọ n g
hay	h a y
thiệu	t h i ệ u
giao	g i a o
trực	t r ự c
rẻ	r ẻ
số	s ố
lượng	l ư ợ n g
kẻ	k ẻ
chết	c h ế t
bổng	b ổ n g
khó	k h ó
trùm	t r ù m
phan	p h a n
quân	q u â n
giặc	g i ặ c
lôi	l ô i
kéo	k é o
quý	q u ý
sai	s a i
nhật	n h ậ t
tích	t í c h
sớm	s ớ m
hung	h u n g
ánh	á n h
chanh	c h a n h
chắc	c h ắ c
chắn	c h ắ n
dành	d à n h
giảm	g i ả m
cân	c â n
đặn	đ ặ n
tăng	t ă n g
rệt	r ệ t
chống	c h ố n g
tuổi	t u ổ i
thọ	t h ọ
nếu	n ế u
chữa	c h ữ a
triệt	t r i ệ t
tai	t a i
nghiêm	n g h i ê m
tức	t ứ c
óc	ó c
tạm	t ạ m
thứ	t h ứ
hoạt	h o ạ t
ổn	ổ n
cải	c ả i
suất	s u ấ t
pin	p i n
so	s o
lứa	l ứ a
mong	m o n g
cán	c á n
dục	d ụ c
tư	t ư
tưởng	t ư ở n g
rèn	r è n
luyện	l u y ệ n
thần	t h ầ n
dáng	d á n g
váy	v á y
bút	b ú t
chì	c h ì
vẻ	v ẻ
quyến	q u y ế n
rũ	r ũ
hắn	h ắ n
lừa	l ừ a
đểu	đ ể u
vôi	v ô i
bột	b ộ t
hoà	h o à
ph	p h
hẹp	h ẹ p
vọng	v ọ n g
nhảy	n h ả y
lũy	l ũ y
kỹ	k ỹ
trợ	t r ợ
nhẫn	n h ẫ n
tâm	t â m
mấy	m ấ y
khóa	k h ó a
cụ	c ụ
non	n o n
đâu	đ â u
thổi	t h ổ i
phong	p h o n g
mắt	m ắ t
niên	n i ê n
bây	b â y
mốt	m ố t
bề	b ề
khôn	k h ô n
cộng	c ộ n g
đáo	đ á o
ngủ	n g ủ
giấc	g i ấ c
ngơi	n g ơ i
giãn	g i ã n
trúc	t r ú c
sư	s ư
nâng	n â n g
đẳng	đ ẳ n g
hàu	h à u
kích	k í c h
khá	k h á
nguy	n g u y
ví	v í
mắc	m ắ c
buồng	b u ồ n g
trứng	t r ứ n g
hữu	h ữ u
nhiễm	n h i ễ m
tòa	t ò a
thuận	t h u ậ n
nhộn	n h ộ n
nhịp	n h ị p
hồi	h ồ i
phạm	p h ạ m
sanh	s a n h
châu	c h â u
phỏng	p h ỏ n g
ngừa	n g ừ a
ung	u n g
mưa	m ư a
thang	t h a n g
nuôi	n u ô i
dĩ	d ĩ
ấm	ấ m
cúng	c ú n g
biển	b i ể n
tơ	t ơ
treo	t r e o
tập	t ậ p
canh	c a n h
rớt	r ớ t
trùng	t r ù n g
đào	đ à o
ca	c a
quá	q u á
hỗ	h ỗ
kiệt	k i ệ t
gồng	g ồ n g
đúng	đ ú n g
pháp	p h á p
luật	l u ậ t
phù	p h ù
lời	l ờ i
khiếu	k h i ế u
nại	n ạ i
kiểm	k i ể m
mối	m ố i
xứ	x ứ
bối	b ố i
bom	b o m
đạn	đ ạ n
khoai	k h o a i
tây	t â y
trữ	t r ữ
liệu	l i ệ u
voan	v o a n
nét	n é t
nàng	n à n g
hảo	h ả o
bên	b ê n
lẫn	l ẫ n
kiểu	k i ể u
chưng	c h ư n g
thắng	t h ắ n g
kiêng	k i ê n g
nà	n à
đoản	đ o ả n
cú	c ú
tã	t ã
thèm	t h è m
tao	t a o
nhỉ	n h ỉ
nè	n è
tiện	t i ệ n
tế	t ế
chờ	c h ờ
kết	k ế t
cuối	c u ố i
tụng	t ụ n g
oanh	o a n h
xác	x á c
chấm	c h ấ m
dứt	d ứ t
buổi	b u ổ i
họp	h ọ p
đồn	đ ồ n
tất	t ấ t
lỗi	l ỗ i
hãy	h ã y
liên	l i ê n
vé	v é
ưu	ư u
đãi	đ ã i
bay	b a y
nhé	n h é
đai	đ a i
lao	l a o
toán	t o á n
quyết	q u y ế t
nát	n á t
bắt	b ắ t
ít	í t
e	e
cái	c á i
ngoan	n g o a n
mảnh	m ả n h
chàng	c h à n g
soái	s o á i
xinh	x i n h
cười	c ư ờ i
chảy	c h ả y
nhổ	n h ổ
tiểu	t i ể u
buốt	b u ố t
vô	v ô
rộng	r ộ n g
rãi	r ã i
phái	p h á i
chim	c h i m
bồ	b ồ
câu	c â u
vừa	v ừ a
ràng	r à n g
mềm	m ề m
ngọt	n g ọ t
thôi	t h ô i
thấp	t h ấ p
đòi	đ ò i
sổ	s ổ
hạn	h ạ n
phú	p h ú
nha	n h a
an	a n
miễn	m i ễ n
phí	p h í
lắp	l ắ p
gọn	g ọ n
lẹ	l ẹ
nối	n ố i
bờ	b ờ
kênh	k ê n h
dị	d ị
ứng	ứ n g
sữa	s ữ a
bú	b ú
phản	p h ả n
thăng	t h ă n g
trầm	t r ầ m
nhọc	n h ọ c
lọc	l ọ c
xơ	x ơ
vải	v ả i
giữ	g i ữ
nhấp	n h ấ p
bảng	b ả n g
đáp	đ á p
trao	t r a o
vỏ	v ỏ
kim	k i m
nghiền	n g h i ề n
mũi	m ũ i
lo	l o
tiếc	t i ế c
rau	r a u
diếp	d i ế p
cá	c á
mụn	m ụ n
nhọt	n h ọ t
sẹo	s ẹ o
nám	n á m
tàn	t à n
nhang	n h a n g
chớ	c h ớ
tỏ	t ỏ
chịu	c h ị u
vài	v à i
khen	k h e n
đòn	đ ò n
roi	r o i
bế	b ế
mâu	m â u
thuẫn	t h u ẫ n
vâng	v â n g
chán	c h á n
đừng	đ ừ n g
cập	c ậ p
phi	p h i
bài	b à i
uống	u ố n g
rượu	r ư ợ u
bia	b i a
tung	t u n g
chiêu	c h i ê u
ngô	n g ô
điên	đ i ê n
phật	p h ậ t
cùa	c ù a
nuốt	n u ố t
rời	r ờ i
khỏi	k h ỏ i
dược	d ư ợ c
bì	b ì
bầu	b ầ u
nắm	n ắ m
ngón	n g ó n
thở	t h ở
tẩm	t ẩ m
ong	o n g
xuống	x u ố n g
nhu	n h u
khuyến	k h u y ế n
khích	k h í c h
chuyển	c h u y ể n
xin	x i n
thau	t h a u
dọn	d ọ n
bể	b ể
quận	q u ậ n
trưng	t r ư n g
khuất	k h u ấ t
tu	t u
tuyệt	t u y ệ t
đao	đ a o
niết	n i ế t
diệt	d i ệ t
béo	b é o
bụng	b ụ n g
hài	h à i
hòa	h ò a
bực	b ự c
bội	b ộ i
tiệm	t i ệ m
tĩnh	t ĩ n h
tống	t ố n g
gậy	g ậ y
chổi	c h ổ i
xua	x u a
trăm	t r ă m
đu	đ u
thừng	t h ừ n g
leo	l e o
vách	v á c h
núi	n ú i
dâng	d â n g
hương	h ư ơ n g
vua	v u a
dưa	d ư a
gang	g a n g
min	m i n
khoáng	k h o á n g
tọa	t ọ a
lạc	l ạ c
trục	t r ụ c
xuân	x u â n
võ	v õ
đỉnh	đ ỉ n h
chẳng	c h ẳ n g
ham	h a m
thăm	t h ă m
lòng	l ò n g
cáo	c á o
oan	o a n
kiều	k i ề u
biện	b i ệ n
gạo	g ạ o
lứt	l ứ t
chuẩn	c h u ẩ n
khám	k h á m
phác	p h á c
lê	l ê
sốt	s ố t
ven	v e n
bùng	b ù n g
gian	g i a n
nỡ	n ỡ
bướm	b ư ớ m
giết	g i ế t
rừng	r ừ n g
ống	ố n g
xô	x ô
ấn	ấ n
xót	x ó t
giọng	g i ọ n g
lừng	l ừ n g
lẫy	l ẫ y
gam	g a m
phom	p h o m
thượng	t h ư ợ n g
phúc	p h ú c
tuýp	t u ý p
sắt	s ắ t
tấn	t ấ n
bóp	b ó p
vong	v o n g
cản	c ả n
tổ	t ổ
trúng	t r ú n g
khắc	k h ắ c
khăn	k h ă n
nắng	n ắ n g
đẩy	đ ẩ y
nôi	n ô i
xách	x á c h
phá	p h á
giang	g i a n g
tạt	t ạ t
a	a
xít	x í t
nhàn	n h à n
khoán	k h o á n
hiển	h i ể n
dữ	d ữ
tợn	t ợ n
xi	x i
nhan	n h a n
trông	t r ô n g
quà	q u à
chiếm	c h i ế m
nhiếp	n h i ế p
quay	q u a y
giường	g i ư ờ n g
chối	c h ố i
bắc	b ắ c
chảo	c h ả o
ngập	n g ậ p
bếp	b ế p
chiên	c h i ê n
vàng	v à n g
mông	m ô n g
mi	m i
duyên	d u y ê n
pô	p ô
ngay	n g a y
dấu	d ấ u
kĩ	k ĩ
nồng	n ồ n g
nhẹn	n h ẹ n
mưu	m ư u
tăm	t ă m
bừng	b ừ n g
sặc	s ặ c
sỡ	s ỡ
bứt	b ứ t
rứt	r ứ t
căng	c ă n g
thẳng	t h ẳ n g
loạn	l o ạ n
cuồng	c u ồ n g
thoát	t h o á t
chốn	c h ố n
ngục	n g ụ c
phủ	p h ủ
vàn	v à n
gà	g à
om	o m
lang	l a n g
lạ	l ạ
mại	m ạ i
tản	t ả n
chém	c h é m
tấp	t ấ p
gãy	g ã y
vấp	v ấ p
ngã	n g ã
tui	t u i
khẩn	k h ẩ n
vật	v ậ t
thúc	t h ú c
dịp	d ị p
sếp	s ế p
hời	h ờ i
hợt	h ợ t
nhóm	n h ó m
bốn	b ố n
đa	đ a
đỡ	đ ỡ
kém	k é m
mắn	m ắ n
sánh	s á n h
tắt	t ắ t
trút	t r ú t
sườn	s ư ờ n
đĩa	đ ĩ a
rắc	r ắ c
cọng	c ọ n g
xong	x o n g
thù	t h ù
chột	c h ộ t
mực	m ự c
nang	n a n g
ván	v á n
cơm	c ơ m
sét	s é t
bách	b á c h
vội	v ộ i
ạ	ạ
sa	s a
mạc	m ạ c
phía	p h í a
móc	m ó c
gỗ	g ỗ
tắm	t ắ m
sạn	s ạ n
búp	b ú p
bê	b ê
bồn	b ồ n
hư	h ư
hỏng	h ỏ n g
túi	t ú i
giấy	g i ấ y
đảm	đ ả m
môi	m ô i
phần	p h ầ n
vết	v ế t
giun	g i u n
sán	s á n
tội	t ộ i
chừa	c h ừ a
thói	t h ó i
làng	l à n g
bích	b í c h
vẽ	v ẽ
ruộng	r u ộ n g
mướt	m ư ớ t
trọn	t r ọ n
ngôi	n g ô i
sum	s u m
suê	s u ê
lí	l í
ảo	ả o
xem	x e m
đúc	đ ú c
náo	n á o
tha	t h a
quê	q u ê
cạnh	c ạ n h
hãng	h ã n g
mống	m ố n g
vân	v â n
lĩnh	l ĩ n h
phép	p h é p
khiển	k h i ể n
cốt	c ố t
nằm	n ằ m
vỉa	v ỉ a
hè	h è
buôn	b u ô n
chấn	c h ấ n
cuốn	c u ố n
pa	p a
khuyên	k h u y ê n
le	l e
nin	n i n
khán	k h á n
đài	đ à i
xôn	x ô n
xao	x a o
trò	t r ò
đụng	đ ụ n g
đũa	đ ũ a
nhớ	n h ớ
khoản	k h o ả n
xứng	x ứ n g
cám	c á m
đắp	đ ắ p
seo	s e o
rao	r a o
vặt	v ặ t
ắp	ắ p
kỷ	k ỷ
niệm	n i ệ m
song	s o n g
lây	l â y
ngứa	n g ứ a
nốt	n ố t
loét	l o é t
khâu	k h â u
gấu	g ấ u
hổng	h ổ n g
đằng	đ ằ n g
thiên	t h i ê n
quấn	q u ấ n
quýt	q u ý t
mở	m ở
cửa	c ử a
kiên	k i ê n
mạo	m ạ o
choáng	c h o á n g
váng	v á n g
rể	r ể
cấu	c ấ u
khảo	k h ả o
chăm	c h ă m
sóc	s ó c
sắc	s ắ c
thảo	t h ả o
bạch	b ạ c h
thị	t h ị
lìa	l ì a
mách	m á c h
dạ	d ạ
dày	d à y
quảng	q u ả n g
khỏa	k h ỏ a
quản	q u ả n
ngạch	n g ạ c h
khem	k h e m
cà	c à
phê	p h ê
rang	r a n g
hạt	h ạ t
dạo	d ạ o
quanh	q u a n h
tầng	t ầ n g
tương	t ư ơ n g
chăng	c h ă n g
nho	n h o
gồm	g ồ m
xông	x ô n g
kháng	k h á n g
ôtô	ô t ô
chở	c h ở
trú	t r ú
gio	g i o
huyện	h u y ệ n
can	c a n
ma	m a
túy	t ú y
xưởng	x ư ở n g
chụp	c h ụ p
khánh	k h á n h
giấu	g i ấ u
vun	v u n
má	m á
ửng	ử n g
hổ	h ổ
rối	r ố i
ruột	r u ộ t
bơm	b ơ m
giếng	g i ế n g
khoan	k h o a n
thiểu	t h i ể u
mệnh	m ệ n h
vướng	v ư ớ n g
asean	a s e a n
lược	l ư ợ c
vận	v ậ n
tróc	t r ó c
kín	k í n
cứng	c ứ n g
nhắc	n h ắ c
dù	d ù
âm	â m
chững	c h ữ n g
nỗ	n ỗ
phồn	p h ồ n
vinh	v i n h
triển	t r i ể n
đùa	đ ù a
trớn	t r ớ n
cưng	c ư n g
rơi	r ơ i
dở	d ở
khóc	k h ó c
thước	t h ư ớ c
to	t o
vươn	v ư ơ n
thủy	t h ủ y
mau	m a u
ghé	g h é
đón	đ ó n
mổ	m ổ
lư	l ư
ủy	ủ y
yên	y ê n
mùa	m ù a
nực	n ự c
dép	d é p
ninh	n i n h
nập	n ậ p
lỏng	l ỏ n g
măng	m ă n g
đá	đ á
riêng	r i ê n g
buýt	b u ý t
ngưng	n g ư n g
tờ	t ờ
khiêu	k h i ê u
say	s a y
trụi	t r ụ i
chứa	c h ứ a
bồi	b ồ i
khang	k h a n g
vắng	v ắ n g
nôn	n ô n
ói	ó i
gầy	g ầ y
còm	c ò m
nghe	n g h e
khò	k h ò
khè	k h è
tái	t á i
ích	í c h
gân	g â n
chằng	c h ằ n g
diệp	d i ệ p
nhập	n h ậ p
nuối	n u ố i
ngoái	n g o á i
nhũng	n h ũ n g
chườm	c h ư ờ m
rên	r ê n
khẳng	k h ẳ n g
ngồi	n g ồ i
sảnh	s ả n h
khoảng	k h o ả n g
sân	s â n
nới	n ớ i
thấu	t h ấ u
xăm	x ă m
nề	n ề
cờ	c ờ
bãi	b ã i
bọn	b ọ n
tuyền	t u y ề n
lâm	l â m
cẩn	c ẩ n
thận	t h ậ n
sầm	s ầ m
uất	u ấ t
ngành	n g à n h
nghề	n g h ề
buông	b u ô n g
chiểu	c h i ể u
cậu	c ậ u
ồn	ồ n
oxy	o x y
bọc	b ọ c
chài	c h à i
ẩm	ẩ m
lớp	l ớ p
tươi	t ư ơ i
dẫu	d ẫ u
sẻ	s ẻ
dính	d í n h
liền	l i ề n
đức	đ ứ c
tháo	t h á o
bục	b ụ c
lò	l ò
giảng	g i ả n g
cẩm	c ẩ m
tùy	t ù y
búa	b ú a
tạ	t ạ
bung	b u n g
ập	ậ p
dối	d ố i
doạ	d o ạ
thoi	t h o i
thóp	t h ó p
ương	ư ơ n g
thơ	t h ơ
vóc	v ó c
hãi	h ã i
sầu	s ầ u
chín	c h í n
hái	h á i
ủ	ủ
héo	h é o
đành	đ à n h
hèn	h è n
ghê	g h ê
cằn	c ằ n
nhằn	n h ằ n
chửi	c h ử i
mắng	m ắ n g
khơi	k h ơ i
bám	b á m
tôm	t ô m
thí	t h í
nhào	n h à o
vón	v ó n
cục	c ụ c
khép	k h é p
lái	l á i
lùi	l ù i
xoay	x o a y
tốc	t ố c
bữa	b ữ a
đợi	đ ợ i
nạ	n ạ
gan	g a n
bánh	b á n h
khổng	k h ổ n g
lồ	l ồ
kem	k e m
sút	s ú t
gạt	g ạ t
ái	á i
tre	t r e
hang	h a n g
sừng	s ừ n g
cheo	c h e o
quăng	q u ă n g
lạch	l ạ c h
ổ	ổ
rêu	r ê u
tỉ	t ỉ
mỉ	m ỉ
ráp	r á p
se	s e
khít	k h í t
thuê	t h u ê
taxi	t a x i
tổng	t ổ n g
đốc	đ ố c
lùng	l ù n g
khái	k h á i
bạc	b ạ c
hắt	h ắ t
hủi	h ủ i
sững	s ữ n g
sờ	s ờ
thẻ	t h ẻ
lãi	l ã i
gợi	g ợ i
nhăn	n h ă n
nhượng	n h ư ợ n g
nở	n ở
hướng	h ư ớ n g
sỏi	s ỏ i
nhiệm	n h i ệ m
lén	l é n
đấy	đ ấ y
ga	g a
gối	g ố i
xu	x u
mạt	m ạ t
bụ	b ụ
bẫm	b ẫ m
vọt	v ọ t
gói	g ó i
diệu	d i ệ u
nhờ	n h ờ
tẻ	t ẻ
bời	b ờ i
lô	l ô
trộm	t r ộ m
nộp	n ộ p
phạt	p h ạ t
ngầm	n g ầ m
mập	m ậ p
lộng	l ộ n g
lấp	l ấ p
lánh	l á n h
ngàn	n g à n
nga	n g a
bão	b ã o
tụt	t ụ t
huỳnh	h u ỳ n h
điểu	đ i ể u
thuyên	t h u y ê n
thao	t h a o
loài	l o à i
lệ	l ệ
tiêm	t i ê m
nguồn	n g u ồ n
vựng	v ự n g
đạt	đ ạ t
vững	v ữ n g
ngữ	n g ữ
xạ	x ạ
giặt	g i ặ t
mẻ	m ẻ
vớt	v ớ t
nguội	n g u ộ i
xối	x ố i
men	m e n
đem	đ e m
nung	n u n g
tuần	t u ầ n
tuông	t u ô n g
ghét	g h é t
thụ	t h ụ
thỏa	t h ỏ a
mãn	m ã n
dạng	d ạ n g
tửu	t ử u
ướm	ư ớ m
triệu	t r i ệ u
chẩn	c h ẩ n
đoán	đ o á n
nứt	n ứ t
chịt	c h ị t
chít	c h í t
chữ	c h ữ
cấy	c ấ y
ghép	g h é p
ẩn	ẩ n
băn	b ă n
khoăn	k h o ă n
cận	c ậ n
kề	k ề
đương	đ ư ơ n g
nạp	n ạ p
chan	c h a n
dường	d ư ờ n g
nổ	n ổ
hy	h y
ngươi	n g ư ơ i
rốt	r ố t
múa	m ú a
già	g i à
tát	t á t
ngà	n g à
cống	c ố n g
xả	x ả
xếp	x ế p
lốt	l ố t
bến	b ế n
săn	s ă n
đà	đ à
nẵng	n ẵ n g
hước	h ư ớ c
phán	p h á n
phấn	p h ấ n
viền	v i ề n
chọc	c h ọ c
húp	h ú p
sụt	s ụ t
kì	k ì
mọc	m ọ c
hát	h á t
ném	n é m
chai	c h a i
kẹp	k ẹ p
sấy	s ấ y
gánh	g á n h
đè	đ è
giày	g i à y
cước	c ư ớ c
trách	t r á c h
cành	c à n h
thuyết	t h u y ế t
ấp	ấ p
ôi	ô i
nhầm	n h ầ m
bấm	b ấ m
nút	n ú t
thiệt	t h i ệ t
bướng	b ư ớ n g
hí	h í
ầm	ầ m
ĩ	ĩ
ghi	g h i
rào	r à o
thánh	t h á n h
đoạt	đ o ạ t
trinh	t r i n h
muộn	m u ộ n
lồng	l ồ n g
lột	l ộ t
lai	l a i
nhảm	n h ả m
nhưỡng	n h ư ỡ n g
khoe	k h o e
luồn	l u ồ n
hổi	h ổ i
gắng	g ắ n g
biên	b i ê n
dựa	d ự a
dãy	d ã y
muối	m u ố i
chinh	c h i n h
cựu	c ự u
hàn	h à n
hầm	h ầ m
thoáng	t h o á n g
đỗ	đ ỗ
mơ	m ơ
mộng	m ộ n g
đạp	đ ạ p
ngáp	n g á p
lác	l á c
đác	đ á c
ngửa	n g ử a
liệt	l i ệ t
tuân	t u â n
thợ	t h ợ
thuyền	t h u y ề n
nhiêu	n h i ê u
thắc	t h ắ c
thự	t h ự
ngọ	n g ọ
trồng	t r ồ n g
cổng	c ổ n g
thép	t h é p
chạm	c h ạ m
trổ	t r ổ
nhậu	n h ậ u
cược	c ư ợ c
mời	m ờ i
phen	p h e n
khổ	k h ổ
nhược	n h ư ợ c
nan	n a n
mí	m í
nếp	n ế p
hi	h i
trọ	t r ọ
ngạc	n g ạ c
giai	g i a i
chăn	c h ă n
xệ	x ệ
xí	x í
dắt	d ắ t
khung	k h u n g
cất	c ấ t
chao	c h a o
chục	c h ụ c
thậm	t h ậ m
vời	v ờ i
màn	m à n
kịt	k ị t
lũi	l ũ i
lói	l ó i
bới	b ớ i
đập	đ ậ p
soi	s o i
quặng	q u ặ n g
đính	đ í n h
xóm	x ó m
dặn	d ặ n
vĩnh	v ĩ n h
tràng	t r à n g
lắng	l ắ n g
rạn	r ạ n
tải	t ả i
dần	d ầ n
van	v a n
ráo	r á o
gắn	g ắ n
thác	t h á c
rạch	r ạ c h
rốn	r ố n
chào	c h à o
mẩu	m ẩ u
lụa	l ụ a
thua	t h u a
chỉnh	c h ỉ n h
băng	b ă n g
tân	t â n
trừ	t r ừ
lan	l a n
hường	h ư ờ n g
trăng	t r ă n g
dời	d ờ i
châm	c h â m
họa	h ọ a
truyện	t r u y ệ n
cắm	c ắ m
khủng	k h ủ n g
khiếp	k h i ế p
mọt	m ọ t
trầy	t r ầ y
xước	x ư ớ c
suôn	s u ô n
tủy	t ủ y
lanh	l a n h
đốt	đ ố t
đẻ	đ ẻ
nhút	n h ú t
xoa	x o a
vỗ	v ỗ
khắp	k h ắ p
tuyến	t u y ế n
thuần	t h u ầ n
củ	c ủ
tỉa	t ỉ a
dẹp	d ẹ p
tim	t i m
bỉnh	b ỉ n h
sụn	s ụ n
tồn	t ồ n
lụy	l ụ y
luân	l u â n
thôn	t h ô n
hoành	h o à n h
xăng	x ă n g
chật	c h ậ t
sol	s o l
huấn	h u ấ n
mỡ	m ỡ
nịt	n ị t
đọng	đ ọ n g
lặng	l ặ n g
ủi	ủ i
hàm	h à m
cắn	c ắ n
nhem	n h e m
nhuốc	n h u ố c
phường	p h ư ờ n g
cử	c ử
trật	t r ậ t
bồng	b ồ n g
bềnh	b ề n h
ren	r e n
cóc	c ó c
êm	ê m
xưa	x ư a
thả	t h ả
thầy	t h ầ y
bậc	b ậ c
hưng	h ư n g
trại	t r ạ i
nhắn	n h ắ n
thò	t h ò
vẫy	v ẫ y
xung	x u n g
gióng	g i ó n g
mèo	m è o
chủng	c h ủ n g
soát	s o á t
đốm	đ ố m
tím	t í m
dư	d ư
thô	t h ô
quyên	q u y ê n
tà	t à
rực	r ự c
rỡ	r ỡ
khởi	k h ở i
my	m y
khinh	k h i n h
phức	p h ứ c
thưởng	t h ư ở n g
chui	c h u i
né	n é
mâm	m â m
ghế	g h ế
móng	m ó n g
đậm	đ ậ m
khoái	k h o á i
sún	s ú n
nhai	n h a i
chậm	c h ậ m
sảo	s ả o
cong	c o n g
đãng	đ ã n g
hủ	h ủ
riềng	r i ề n g
tỏi	t ỏ i
giã	g i ã
nhuyễn	n h u y ễ n
trộn	t r ộ n
heo	h e o
nêm	n ê m
quét	q u é t
quên	q u ê n
hlv	h l v
tỳ	t ỳ
tổn	t ổ n
tạng	t ạ n g
mút	m ú t
đệm	đ ệ m
cháy	c h á y
chảnh	c h ả n h
ngào	n g à o
xích	x í c h
mượn	m ư ợ n
gỡ	g ỡ
phiên	p h i ê n
kịch	k ị c h
hoãn	h o ã n
lạm	l ạ m
hòn	h ò n
khéo	k h é o
đạc	đ ạ c
khẩu	k h ẩ u
nấu	n ấ u
dằn	d ằ n
nhí	n h í
nhảnh	n h ả n h
gấp	g ấ p
bù	b ù
tuấn	t u ấ n
thản	t h ả n
quang	q u a n g
lốp	l ố p
dạy	d ạ y
cội	c ộ i
li	l i
phơi	p h ơ i
sạt	s ạ t
lở	l ở
soạn	s o ạ n
cuống	c u ố n g
hối	h ố i
hả	h ả
ruồi	r u ồ i
tả	t ả
kiết	k i ế t
lị	l ị
đậu	đ ậ u
hận	h ậ n
hiền	h i ề n
chuồng	c h u ồ n g
vượt	v ư ợ t
phóng	p h ó n g
bạt	b ạ t
lấn	l ấ n
vở	v ở
điển	đ i ể n
gáy	g á y
trẹo	t r ẹ o
quai	q u a i
nghẹn	n g h ẹ n
ngôn	n g ô n
lối	l ố i
quỳnh	q u ỳ n h
phó	p h ó
cúc	c ú c
quỳ	q u ỳ
sạm	s ạ m
ngừng	n g ừ n g
vai	v a i
bênh	b ê n h
thịnh	t h ị n h
kép	k é p
chiêm	c h i ê m
doãn	d o ã n
vảy	v ả y
xé	x é
toạc	t o ạ c
bỉm	b ỉ m
tấu	t ấ u
đo	đ o
trội	t r ộ i
đảng	đ ả n g
ngụy	n g ụ y
đồi	đ ồ i
trụy	t r ụ y
tần	t ầ n
ngần	n g ầ n
vuông	v u ô n g
kèm	k è m
đựng	đ ự n g
gìn	g ì n
điệp	đ i ệ p
mẫn	m ẫ n
nảy	n ả y
chước	c h ư ớ c
hôi	h ô i
xảo	x ả o
khử	k h ử
tiệt	t i ệ t
khuẩn	k h u ẩ n
trấn	t r ấ n
mạch	m ạ c h
khúc	k h ú c
chiết	c h i ế t
tẩy	t ẩ y
ớt	ớ t
siêu	s i ê u
quẩn	q u ẩ n
mây	m â y
sâm	s â m
hỏa	h ỏ a
cháu	c h á u
khuya	k h u y a
huỷ	h u ỷ
ngắt	n g ắ t
gài	g à i
nhấn	n h ấ n
xét	x é t
suy	s u y
thủng	t h ủ n g
lưỡng	l ư ỡ n g
rằm	r ằ m
mùng	m ù n g
tết	t ế t
tuỳ	t u ỳ
côn	c ô n
trạm	t r ạ m
thầm	t h ầ m
ơn	ơ n
vĩ	v ĩ
tủi	t ủ i
bấy	b ấ y
tanh	t a n h
bành	b à n h
mịch	m ị c h
chua	c h u a
gừng	g ừ n g
rồng	r ồ n g
suối	s u ố i
duyệt	d u y ệ t
toan	t o a n
phũ	p h ũ
phàng	p h à n g
gỏi	g ỏ i
dừa	d ừ a
giòn	g i ò n
đền	đ ề n
chen	c h e n
xỉ	x ỉ
rách	r á c h
mini	m i n i
album	a l b u m
tấm	t ấ m
đắc	đ ắ c
nhuận	n h u ậ n
mì	m ì
sệt	s ệ t
vo	v o
rỉ	r ỉ
thê	t h ê
kỵ	k ỵ
hao	h a o
tán	t á n
than	t h a n
mô	m ô
gập	g ậ p
chuỗi	c h u ỗ i
nhạy	n h ạ y
bén	b é n
vây	v â y
virus	v i r u s
trám	t r á m
xỉn	x ỉ n
kitô	k i t ô
cõi	c õ i
phách	p h á c h
miêu	m i ê u
mãnh	m ã n h
ôn	ô n
trận	t r ậ n
nón	n ó n
vành	v à n h
ngoạn	n g o ạ n
chạp	c h ạ p
nền	n ề n
cu	c u
đàm	đ à m
băm	b ă m
miền	m i ề n
xài	x à i
rễ	r ễ
vịt	v ị t
giỗ	g i ỗ
phiêu	p h i ê u
cởi	c ở i
à	à
kg	k g
giầy	g i ầ y
dẻo	d ẻ o
gãi	g ã i
nghiệt	n g h i ệ t
viễn	v i ễ n
nấm	n ấ m
bặm	b ặ m
sập	s ậ p
á	á
thon	t h o n
gạch	g ạ c h
ngổn	n g ổ n
phiền	p h i ề n
trích	t r í c h
ngọn	n g ọ n
táp	t á p
cỏ	c ỏ
dại	d ạ i
trèo	t r è o
mẹo	m ẹ o
xù	x ù
im	i m
nhựa	n h ự a
thoa	t h o a
son	s o n
vang	v a n g
lộn	l ộ n
g	g
thụy	t h ụ y
trân	t r â n
tít	t í t
thoả	t h o ả
sướng	s ư ớ n g
chìm	c h ì m
đắm	đ ắ m
phượng	p h ư ợ n g
nắp	n ắ p
mờ	m ờ
sương	s ư ơ n g
ã	ã
miên	m i ê n
ốm	ố m
tốn	t ố n
chứ	c h ứ
lọt	l ọ t
lợn	l ợ n
nghênh	n g h ê n h
trừng	t r ừ n g
rắn	r ắ n
ưa	ư a
chuộng	c h u ộ n g
i	i
ngu	n g u
dốt	d ố t
đần	đ ầ n
độn	đ ộ n
nghệch	n g h ệ c h
tủ	t ủ
mặn	m ặ n
nén	n é n
quẹo	q u ẹ o
rặng	r ặ n g
rượi	r ư ợ i
cọ	c ọ
mỏ	m ỏ
rác	r á c
vất	v ấ t
khoá	k h o á
sáu	s á u
nẻ	n ẻ
lán	l á n
khoắn	k h o ắ n
bân	b â n
vụng	v ụ n g
ào	à o
đói	đ ó i
lầu	l ầ u
oi	o i
ả	ả
vẹn	v ẹ n
khiếm	k h i ế m
khuyết	k h u y ế t
gắt	g ắ t
hứa	h ứ a
cạch	c ạ c h
dai	d a i
nhách	n h á c h
nghét	n g h é t
xén	x é n
tịnh	t ị n h
phụng	p h ụ n g
hủy	h ủ y
lượt	l ư ợ t
nhũ	n h ũ
lúa	l ú a
rút	r ú t
huế	h u ế
cự	c ự
khứu	k h ứ u
thốt	t h ố t
giận	g i ậ n
cãi	c ã i
rơm	r ơ m
ướp	ư ớ p
nướng	n ư ớ n g
hán	h á n
ti	t i
quạnh	q u ạ n h
lọ	l ọ
mọ	m ọ
hoắc	h o ắ c
rảnh	r ả n h
vạch	v ạ c h
chênh	c h ê n h
video	v i d e o
mỉm	m ỉ m
ngán	n g á n
dán	d á n
dì	d ì
nông	n ô n g
ân	â n
hất	h ấ t
the	t h e
vỡ	v ỡ
thục	t h ụ c
khôi	k h ô i
cỗ	c ỗ
bó	b ó
nhàng	n h à n g
sói	s ó i
xám	x á m
thỏ	t h ỏ
sành	s à n h
bảy	b ả y
vạn	v ạ n
nọ	n ọ
gót	g ó t
tôn	t ô n
lượn	l ư ợ n
liều	l i ề u
thược	t h ư ợ c
cụm	c ụ m
gioăng	g i o ă n g
tứ	t ứ
thà	t h à
dặm	d ặ m
hựu	h ự u
điệu	đ i ệ u
cữ	c ữ
ngượng	n g ư ợ n g
bận	b ậ n
béng	b é n g
tùng	t ù n g
phiến	p h i ế n
súng	s ú n g
đứt	đ ứ t
gẫy	g ẫ y
giàn	g i à n
trâm	t r â m
xấp	x ấ p
nạo	n ạ o
úy	ú y
dũng	d ũ n g
túc	t ú c
quấy	q u ấ y
ngủi	n g ủ i
lỡ	l ỡ
mắm	m ắ m
ao	a o
ngớ	n g ớ
ngất	n g ấ t
xỉu	x ỉ u
thỉu	t h ỉ u
kình	k ì n h
tuất	t u ấ t
rủi	r ủ i
ro	r o
lồi	l ồ i
tàng	t à n g
com	c o m
kho	k h o
úc	ú c
mộc	m ộ c
tràn	t r à n
nhớt	n h ớ t
ngắm	n g ắ m
nẫng	n ẫ n g
thấm	t h ấ m
thía	t h í a
giông	g i ô n g
nhó	n h ó
thun	t h u n
vứt	v ứ t
xoang	x o a n g
nhỡ	n h ỡ
sảy	s ả y
toi	t o i
mác	m á c
dám	d á m
khuê	k h u ê
nghìn	n g h ì n
thằng	t h ằ n g
cuội	c u ộ i
cương	c ư ơ n g
cạn	c ạ n
đê	đ ê
vườn	v ư ờ n
quạt	q u ạ t
suýt	s u ý t
trưa	t r ư a
sấu	s ấ u
dội	d ộ i
mường	m ư ờ n g
chà	c h à
hít	h í t
thiền	t h i ề n
yoga	y o g a
bỗng	b ỗ n g
chuyền	c h u y ề n
xui	x u i
xẻo	x ẻ o
ghềnh	g h ề n h
nếm	n ế m
lam	l a m
nhục	n h ụ c
mị	m ị
yếm	y ế m
dụm	d ụ m
súc	s ú c
đùm	đ ù m
hờn	h ờ n
kẽm	k ẽ m
tỵ	t ỵ
khoảnh	k h o ả n h
giáng	g i á n g
ước	ư ớ c
khoang	k h o a n g
chuộc	c h u ộ c
hoạ	h o ạ
ion	i o n
nức	n ứ c
gày	g à y
khoác	k h o á c
ngậm	n g ậ m
cưa	c ư a
trỗi	t r ỗ i
dậy	d ậ y
ám	á m
mầm	m ầ m
phai	p h a i
khăm	k h ă m
mìn	m ì n
phiếu	p h i ế u
vẳng	v ẳ n g
ức	ứ c
nhoáng	n h o á n g
giơ	g i ơ
tưới	t ư ớ i
rạng	r ạ n g
thuế	t h u ế
thiệp	t h i ệ p
bẻ	b ẻ
phồng	p h ồ n g
oa	o a
keo	k e o
núm	n ú m
khe	k h e
thốn	t h ố n
lự	l ự
phô	p h ô
bi	b i
nơ	n ơ
lệnh	l ệ n h
tành	t à n h
khát	k h á t
tựu	t ự u
bọng	b ọ n g
sưng	s ư n g
hộp	h ộ p
lẫm	l ẫ m
h	h
bắn	b ắ n
niêm	n i ê m
râm	r â m
tuệ	t u ệ
top	t o p
sưu	s ư u
xốp	x ố p
trán	t r á n
niu	n i u
đun	đ u n
rộn	r ộ n
giành	g i à n h
hoán	h o á n
sùng	s ù n g
bái	b á i
đò	đ ò
phà	p h à
phao	p h a o
rầm	r ầ m
hét	h é t
gào	g à o
gò	g ò
quế	q u ế
đậy	đ ậ y
gàng	g à n g
n	n
gao	g a o
mồng	m ồ n g
sùi	s ù i
mào	m à o
sỉ	s ỉ
lẻ	l ẻ
liêm	l i ê m
nhở	n h ở
co	c o
stress	s t r e s s
dồn	d ồ n
dập	d ậ p
đống	đ ố n g
mồm	m ồ m
tảng	t ả n g
xíu	x í u
ùn	ù n
nêu	n ê u
khấu	k h ấ u
đế	đ ế
mừng	m ừ n g
phẫn	p h ẫ n
loi	l o i
bắp	b ắ p
ngẩm	n g ẩ m
lắc	l ắ c
trịnh	t r ị n h
rà	r à
sẩy	s ẩ y
thét	t h é t
dãn	d ã n
nhốt	n h ố t
vía	v í a
pu	p u
va	v a
tri	t r i
tru	t r u
loãng	l o ã n g
canxi	c a n x i
chẽ	c h ẽ
hụt	h ụ t
mangan	m a n g a n
rình	r ì n h
mò	m ò
thờ	t h ờ
léo	l é o
m	m
robot	r o b o t
nao	n a o
bớt	b ớ t
bèo	b è o
muỗi	m u ỗ i
lăn	l ă n
nhúng	n h ú n g
vụn	v ụ n
hoang	h o a n g
nồi	n ồ i
đùi	đ ù i
bóc	b ó c
bòn	b ò n
bon	b o n
mủ	m ủ
quầng	q u ầ n g
bàng	b à n g
sạc	s ạ c
ốc	ố c
mĩ	m ĩ
rung	r u n g
vy	v y
chùm	c h ù m
me	m e
nghịch	n g h ị c h
ngợm	n g ợ m
giấm	g i ấ m
hóc	h ó c
phun	p h u n
ướt	ư ớ t
gán	g á n
cáng	c á n g
tang	t a n g
dõi	d õ i
lề	l ề
lưới	l ư ớ i
cắp	c ắ p
ngải	n g ả i
xắn	x ắ n
phận	p h ậ n
hễ	h ễ
địch	đ ị c h
nã	n ã
ngàng	n g à n g
nến	n ế n
mỏng	m ỏ n g
đờ	đ ờ
vãi	v ã i
lau	l a u
quắt	q u ắ t
thề	t h ề
ngớt	n g ớ t
chậu	c h ậ u
toà	t o à
láng	l á n g
giềng	g i ề n g
bẩm	b ẩ m
dọc	d ọ c
ơi	ơ i
gã	g ã
nhàm	n h à m
chó	c h ó
khay	k h a y
chìa	c h ì a
mãi	m ã i
khứ	k h ứ
pháo	p h á o
khoát	k h o á t
ngây	n g â y
trướng	t r ư ớ n g
nhì	n h ì
truy	t r u y
liễu	l i ễ u
dỗi	d ỗ i
cớ	c ớ
biếm	b i ế m
gặt	g ặ t
binh	b i n h
xiếc	x i ế c
trơ	t r ơ
bốc	b ố c
mù	m ù
mịt	m ị t
mảng	m ả n g
chừng	c h ừ n g
trôi	t r ô i
séc	s é c
âu	â u
chúa	c h ú a
ngói	n g ó i
chê	c h ê
xướng	x ư ớ n g
miều	m i ề u
đuôi	đ u ô i
mét	m é t
cậy	c ậ y
bít	b í t
nâu	n â u
tào	t à o
phớ	p h ớ
xào	x à o
bằm	b ằ m
loa	l o a
ngách	n g á c h
xộn	x ộ n
tem	t e m
krông	k r ô n g
thùng	t h ù n g
lênh	l ê n h
khênh	k h ê n h
phớt	p h ớ t
lãm	l ã m
nần	n ầ n
đoan	đ o a n
dông	d ô n g
thày	t h à y
bói	b ó i
sụ	s ụ
sụp	s ụ p
diêu	d i ê u
rập	r ậ p
giương	g i ư ơ n g
ngấn	n g ấ n
bẹt	b ẹ t
tíu	t í u
hở	h ở
xuồng	x u ồ n g
sót	s ó t
ưng	ư n g
quyệt	q u y ệ t
ok	o k
ư	ư
dua	d u a
hong	h o n g
ngoai	n g o a i
bào	b à o
mòn	m ò n
lố	l ố
bịch	b ị c h
thạo	t h ạ o
hơ	h ơ
hớ	h ớ
chốt	c h ố t
giây	g i â y
ngộ	n g ộ
ngặt	n g ặ t
nghèo	n g h è o
chồn	c h ồ n
ghẻ	g h ẻ
lũ	l ũ
mốc	m ố c
lửng	l ử n g
thửa	t h ử a
đ	đ
tách	t á c h
phôi	p h ô i
trót	t r ó t
kiếp	k i ế p
ế	ế
tằm	t ằ m
rả	r ả
thút	t h ú t
thít	t h í t
lính	l í n h
đắn	đ ắ n
đếm	đ ế m
xuể	x u ể
quát	q u á t
san	s a n
thòi	t h ò i
sửng	s ử n g
cưỡng	c ư ỡ n g
nhặt	n h ặ t
nhăng	n h ă n g
dưng	d ư n g
cồn	c ồ n
khoẻ	k h o ẻ
đày	đ à y
đọa	đ ọ a
lạt	l ạ t
ri	r i
sảng	s ả n g
giãi	g i ã i
b	b
nguôi	n g u ô i
khốc	k h ố c
vút	v ú t
lệch	l ệ c h
thắm	t h ắ m
nằng	n ằ n g
nặc	n ặ c
hê	h ê
trễ	t r ễ
khắt	k h ắ t
nguyện	n g u y ệ n
trẻo	t r ẻ o
sủa	s ủ a
uỷ	u ỷ
mớ	m ớ
trâu	t r â u
bơ	b ơ
vú	v ú
trốn	t r ố n
chần	c h ầ n
chừ	c h ừ
nhối	n h ố i
bùa	b ù a
mao	m a o
coi	c o i
sượng	s ư ợ n g
đặng	đ ặ n g
lường	l ư ờ n g
nản	n ả n
calo	c a l o
săm	s ă m
vét	v é t
mương	m ư ơ n g
bấn	b ấ n
hắc	h ắ c
mé	m é
năn	n ă n
nỉ	n ỉ
giỏ	g i ỏ
lì	l ì
lung	l u n g
que	q u e
chè	c h è
tho	t h o
qui	q u i
chay	c h a y
luộc	l u ộ c
ngao	n g a o
gạn	g ạ n
cặn	c ặ n
lặp	l ặ p
sởi	s ở i
vác	v á c
rựa	r ự a
nai	n a i
xoá	x o á
dâm	d â m
ranh	r a n h
sáp	s á p
thỏi	t h ỏ i
cóp	c ó p
ải	ả i
sen	s e n
đượm	đ ư ợ m
toát	t o á t
tý	t ý
gáp	g á p
nạc	n ạ c
cuộn	c u ộ n
cửu	c ử u
tơi	t ơ i
rộ	r ộ
đèo	đ è o
xòe	x ò e
nách	n á c h
trọt	t r ọ t
rệ	r ệ
suông	s u ô n g
nhặn	n h ặ n
ngựa	n g ự a
khải	k h ả i
đôn	đ ô n
nhá	n h á
lụt	l ụ t
thiếp	t h i ế p
hoan	h o a n
nom	n o m
k	k
bô	b ô
chập	c h ậ p
mũm	m ũ m
mĩm	m ĩ m
bụt	b ụ t
thiêu	t h i ê u
rụi	r ụ i
lều	l ề u
điêu	đ i ê u
toilet	t o i l e t
lữ	l ữ
sởn	s ở n
gai	g a i
ốp	ố p
lát	l á t
hoại	h o ạ i
gượng	g ư ợ n g
hấu	h ấ u
mark	m a r k
tua	t u a
rua	r u a
trác	t r á c
thúy	t h ú y
cài	c à i
nhơn	n h ơ n
lóc	l ó c
đấng	đ ấ n g
na	n a
ẩu	ẩ u
mếu	m ế u
mích	m í c h
riết	r i ế t
thắn	t h ắ n
chuột	c h u ộ t
sôi	s ô i
phế	p h ế
xá	x á
nhịn	n h ị n
nong	n o n g
mẩn	m ẩ n
nghiện	n g h i ệ n
sàm	s à m
thót	t h ó t
gián	g i á n
gas	g a s
tò	t ò
cáu	c á u
rùng	r ù n g
sấp	s ấ p
bọt	b ọ t
níu	n í u
bệt	b ệ t
vàm	v à m
phết	p h ế t
kít	k í t
thuỷ	t h u ỷ
teo	t e o
tóp	t ó p
quắp	q u ắ p
gác	g á c
mão	m ã o
bai	b a i
tậu	t ậ u
nhái	n h á i
no	n o
nấc	n ấ c
sưởi	s ư ở i
cs	c s
háng	h á n g
đợt	đ ợ t
vòi	v ò i
bar	b a r
bẩy	b ẩ y
dang	d a n g
kẹt	k ẹ t
khét	k h é t
lẹt	l ẹ t
tựa	t ự a
trắc	t r ắ c
test	t e s t
út	ú t
trù	t r ù
ấu	ấ u
hỉ	h ỉ
biếu	b i ế u
neo	n e o
kìm	k ì m
hãm	h ã m
tị	t ị
quãng	q u ã n g
rỗi	r ỗ i
chúc	c h ú c
vũng	v ũ n g
l	l
dê	d ê
giục	g i ụ c
gắm	g ắ m
tráng	t r á n g
giắt	g i ắ t
v	v
chùi	c h ù i
sung	s u n g
bón	b ó n
thiều	t h i ề u
phiện	p h i ệ n
nhầy	n h ầ y
ngâm	n g â m
quỵ	q u ỵ
hiếp	h i ế p
củng	c ủ n g
mài	m à i
uốn	u ố n
khóe	k h ó e
nộm	n ộ m
ếch	ế c h
lươn	l ư ơ n
nương	n ư ơ n g
rẫy	r ẫ y
khốn	k h ố n
nhõm	n h õ m
trệt	t r ệ t
mụ	m ụ
xay	x a y
nành	n à n h
sạp	s ạ p
nhóc	n h ó c
khan	k h a n
trồi	t r ồ i
đinh	đ i n h
thượt	t h ư ợ t
muống	m u ố n g
dền	d ề n
éo	é o
huynh	h u y n h
hốt	h ố t
uể	u ể
đàng	đ à n g
hiên	h i ê n
mồi	m ồ i
nhô	n h ô
lưỡi	l ư ỡ i
ruồng	r u ồ n g
dửng	d ử n g
dò	d ò
khiết	k h i ế t
rụt	r ụ t
rè	r è
trớ	t r ớ
trêu	t r ê u
tuý	t u ý
dăm	d ă m
mè	m è
nhọn	n h ọ n
phăng	p h ă n g
chướng	c h ư ớ n g
tê	t ê
gươm	g ư ơ m
vơi	v ơ i
vali	v a l i
sợi	s ợ i
lòa	l ò a
núc	n ú c
chải	c h ả i
nhung	n h u n g
bùi	b ù i
phất	p h ấ t
diễu	d i ễ u
gật	g ậ t
gù	g ù
võng	v õ n g
nghé	n g h é
chau	c h a u
ỷ	ỷ
bỉ	b ỉ
khiên	k h i ê n
hũ	h ũ
dí	d í
ỡm	ỡ m
ờ	ờ
triết	t r i ế t
luyến	l u y ế n
hố	h ố
thầu	t h ầ u
chánh	c h á n h
mành	m à n h
rèm	r è m
sáo	s á o
ngáy	n g á y
tẩu	t ẩ u
nhét	n h é t
gổ	g ổ
đả	đ ả
thạnh	t h ạ n h
vén	v é n
kha	k h a
kiếng	k i ế n g
hiến	h i ế n
ngẫu	n g ẫ u
ị	ị
đơ	đ ơ
ngẩn	n g ẩ n
ngơ	n g ơ
manh	m a n h
vèo	v è o
ngưỡng	n g ư ỡ n g
eo	e o
lầy	l ầ y
rong	r o n g
dột	d ộ t
lổ	l ổ
luồng	l u ồ n g
giằng	g i ằ n g
mía	m í a
dè	d è
nghinh	n g h i n h
bong	b o n g
nhiếc	n h i ế c
cúm	c ú m
cồng	c ồ n g
chiêng	c h i ê n g
kiềm	k i ề m
d	d
chép	c h é p
thềm	t h ề m
đẽ	đ ẽ
man	m a n
kiêu	k i ê u
lui	l u i
ruổi	r u ổ i
hấn	h ấ n
ngoi	n g o i
vạ	v ạ
tước	t ư ớ c
trĩ	t r ĩ
nheo	n h e o
nhẵn	n h ẵ n
chùa	c h ù a
hươu	h ư ơ u
máo	m á o
cháo	c h á o
ka	k a
mụi	m ụ i
cốp	c ố p
ho	h o
lẩu	l ẩ u
xắt	x ắ t
rước	r ư ớ c
táng	t á n g
xoong	x o o n g
huyền	h u y ề n
sủng	s ủ n g
tụ	t ụ
hãnh	h ã n h
tấc	t ấ c
lon	l o n
thui	t h u i
thủi	t h ủ i
nhói	n h ó i
xoăn	x o ă n
oái	o á i
ăm	ă m
rán	r á n
cộm	c ộ m
rãnh	r ã n h
chàm	c h à m
kí	k í
khăng	k h ă n g
tằn	t ằ n
khao	k h a o
nhíp	n h í p
cưu	c ư u
nghiêng	n g h i ê n g
thạc	t h ạ c
dĩnh	d ĩ n h
tiều	t i ề u
tuỵ	t u ỵ
nể	n ể
xát	x á t
ngóng	n g ó n g
té	t é
thìa	t h ì a
nhâm	n h â m
kèo	k è o
khế	k h ế
phang	p h a n g
ve	v e
rượt	r ư ợ t
rít	r í t
cỡ	c ỡ
ray	r a y
xoắn	x o ắ n
kiêm	k i ê m
đục	đ ụ c
rò	r ò
tấy	t ấ y
xoài	x o à i
chén	c h é n
siêng	s i ê n g
vấy	v ấ y
nũng	n ũ n g
nịu	n ị u
nhõng	n h õ n g
nhẽo	n h ẽ o
náu	n á u
nhãng	n h ã n g
thổ	t h ổ
nhĩ	n h ĩ
tởm	t ở m
hoi	h o i
tro	t r o
kệ	k ệ
ngấm	n g ấ m
cò	c ò
kè	k è
lõi	l õ i
lười	l ư ờ i
biếng	b i ế n g
sửu	s ử u
vá	v á
ak	a k
mít	m í t
điềm	đ i ề m
đạm	đ ạ m
dong	d o n g
dỏng	d ỏ n g
cặm	c ặ m
cụi	c ụ i
nhị	n h ị
yết	y ế t
rịa	r ị a
phả	p h ả
hót	h ó t
bửu	b ử u
nàn	n à n
mồ	m ồ
hiếu	h i ế u
đễ	đ ễ
đan	đ a n
bướu	b ư ớ u
phùng	p h ù n g
mướp	m ư ớ p
c	c
martin	m a r t i n
p	p
chọi	c h ọ i
mền	m ề n
len	l e n
thiêm	t h i ê m
chả	c h ả
rủ	r ủ
rạp	r ạ p
súp	s ú p
dấp	d ấ p
túng	t ú n g
tiềm	t i ề m
bọ	b ọ
lội	l ộ i
diễm	d i ễ m
mỉa	m ỉ a
visa	v i s a
đẫm	đ ẫ m
nghén	n g h é n
bần	b ầ n
quái	q u á i
đùng	đ ù n g
bịa	b ị a
tóm	t ó m
bừa	b ừ a
xiết	x i ế t
nài	n à i
euro	e u r o
gianh	g i a n h
nhánh	n h á n h
dên	d ê n
suyễn	s u y ễ n
xuôi	x u ô i
rỗng	r ỗ n g
hăng	h ă n g
hạm	h ạ m
át	á t
háo	h á o
ỉ	ỉ
sịt	s ị t
hống	h ố n g
hách	h á c h
nạt	n ạ t
rụng	r ụ n g
ngự	n g ự
hộc	h ộ c
run	r u n
rẩy	r ẩ y
bịt	b ị t
phẳng	p h ẳ n g
chãi	c h ã i
ín	í n
lặn	l ặ n
muôn	m u ô n
tươm	t ư ơ m
phẩy	p h ẩ y
ngừ	n g ừ
liu	l i u
mòng	m ò n g
lút	l ú t
laser	l a s e r
ngưu	n g ư u
côi	c ô i
ầu	ầ u
trói	t r ó i
nhủ	n h ủ
ngư	n g ư
khê	k h ê
sì	s ì
thảnh	t h ả n h
thơi	t h ơ i
ổi	ổ i
khuynh	k h u y n h
ù	ù
ngông	n g ô n g
xuẩn	x u ẩ n
cóng	c ó n g
bấp	b ấ p
cai	c a i
ngậu	n g ậ u
liếc	l i ế c
phiếm	p h i ế m
nhẽ	n h ẽ
nhếch	n h ế c h
nhác	n h á c
điếc	đ i ế c
huơ	h u ơ
lờ	l ờ
đố	đ ố
ố	ố
lay	l a y
tụy	t ụ y
duệ	d u ệ
ngạn	n g ạ n
khảng	k h ả n g
thuột	t h u ộ t
tắn	t ắ n
hởi	h ở i
ram	r a m
dệt	d ệ t
ghẹ	g h ẹ
voọc	v o ọ c
tuộc	t u ộ c
thiêng	t h i ê n g
liêng	l i ê n g
xạo	x ạ o
nhiễu	n h i ễ u
dốc	d ố c
đọ	đ ọ
huê	h u ê
phì	p h ì
hãn	h ã n
phe	p h e
lấm	l ấ m
lét	l é t
gen	g e n
khương	k h ư ơ n g
nộ	n ộ
nhú	n h ú
quặn	q u ặ n
càu	c à u
đáy	đ á y
ngùng	n g ù n g
gõ	g õ
huệ	h u ệ
vạt	v ạ t
ồ	ồ
ạt	ạ t
chường	c h ư ờ n g
bỉu	b ỉ u
múi	m ú i
miến	m i ế n
lõm	l õ m
xen	x e n
quây	q u â y
ngốc	n g ố c
nháo	n h á o
lướt	l ư ớ t
cúi	c ú i
giùm	g i ù m
cốc	c ố c
hạch	h ạ c h
dải	d ả i
km	k m
cào	c à o
hiệp	h i ệ p
x	x
nhợt	n h ợ t
găng	g ă n g
tia	t i a
vịn	v ị n
rọ	r ọ
dấm	d ấ m
dúi	d ú i
cẩu	c ẩ u
cọc	c ọ c
dạt	d ạ t
bầy	b ầ y
quyện	q u y ệ n
ngậy	n g ậ y
quật	q u ậ t
real	r e a l
giũ	g i ũ
vãn	v ã n
shop	s h o p
xịn	x ị n
giáp	g i á p
nhồi	n h ồ i
siết	s i ế t
kali	k a l i
phốt	p h ố t
pho	p h o
sò	s ò
khuỷu	k h u ỷ u
sãi	s ã i
rôn	r ô n
gom	g o m
mải	m ả i
vó	v ó
ngãi	n g ã i
vượng	v ư ợ n g
râu	r â u
dấn	d ấ n
ni	n i
trăn	t r ă n
chồm	c h ồ m
bưởi	b ư ở i
diệc	d i ệ c
phước	p h ư ớ c
rền	r ề n
nhụt	n h ụ t
ganh	g a n h
rôm	r ô m
bết	b ế t
óng	ó n g
reo	r e o
mưng	m ư n g
hiv	h i v
tía	t í a
sả	s ả
mạ	m ạ
trợn	t r ợ n
rỗ	r ỗ
ưỡn	ư ỡ n
quỷ	q u ỷ
nuông	n u ô n g
bẫy	b ẫ y
gọt	g ọ t
thố	t h ố
hập	h ậ p
phàn	p h à n
máng	m á n g
khía	k h í a
rồ	r ồ
chói	c h ó i
khẽ	k h ẽ
mến	m ế n
giam	g i a m
nhòa	n h ò a
khâm	k h â m
chúm	c h ú m
chím	c h í m
ngát	n g á t
lẻo	l ẻ o
oai	o a i
trầu	t r ầ u
sọ	s ọ
huyệt	h u y ệ t
vằng	v ằ n g
hông	h ô n g
chặng	c h ặ n g
thối	t h ố i
trạch	t r ạ c h
phím	p h í m
bộc	b ộ c
vin	v i n
studio	s t u d i o
ngoa	n g o a
niệu	n i ệ u
cuốc	c u ố c
ách	á c h
toả	t o ả
nhún	n h ú n
dạn	d ạ n
dồi	d ồ i
dào	d à o
diều	d i ề u
ắng	ắ n g
miện	m i ệ n
quách	q u á c h
túm	t ú m
đong	đ o n g
lảo	l ả o
ngỡ	n g ỡ
vờ	v ờ
trối	t r ố i
mỗ	m ỗ
còi	c ò i
xẩy	x ẩ y
thóc	t h ó c
lép	l é p
sớt	s ớ t
sải	s ả i
gí	g í
thuở	t h u ở
vẹt	v ẹ t
kelvin	k e l v i n
nhố	n h ố
cảng	c ả n g
ùa	ù a
đỗi	đ ỗ i
cưỡi	c ư ỡ i
chội	c h ộ i
nùng	n ù n g
khau	k h a u
tày	t à y
khấn	k h ấ n
muỗng	m u ỗ n g
đĩnh	đ ĩ n h
trọc	t r ọ c
ngài	n g à i
cù	c ù
diên	d i ê n
lu	l u
thảng	t h ả n g
lượm	l ư ợ m
vặn	v ặ n
nghêu	n g h ê u
há	h á
voi	v o i
đt	đ t
inh	i n h
ỏi	ỏ i
rắt	r ắ t
kẻo	k ẻ o
cua	c u a
văng	v ă n g
khư	k h ư
nết	n ế t
cạo	c ạ o
hanh	h a n h
sần	s ầ n
ơ	ơ
cạm	c ạ m
lựu	l ự u
mọng	m ọ n g
tắp	t ắ p
dôi	d ô i
chuối	c h u ố i
mún	m ú n
lận	l ậ n
sứt	s ứ t
cuông	c u ô n g
én	é n
ợ	ợ
xụp	x ụ p
nỏ	n ỏ
ton	t o n
ngùi	n g ù i
phu	p h u
hun	h u n
chắt	c h ắ t
chiu	c h i u
noãn	n o ã n
pop	p o p
rock	r o c k
xê	x ê
điền	đ i ề n
dát	d á t
vợt	v ợ t
cằm	c ằ m
bạnh	b ạ n h
đước	đ ư ớ c
hưu	h ư u
hen	h e n
hẹ	h ẹ
yểu	y ể u
nải	n ả i
gara	g a r a
vớ	v ớ
vẩn	v ẩ n
thìn	t h ì n
nhả	n h ả
bùn	b ù n
lem	l e m
bang	b a n g
cừu	c ừ u
xuýt	x u ý t
hức	h ứ c
ngầu	n g ầ u
mẫm	m ẫ m
karaoke	k a r a o k e
gu	g u
tí	t í
vức	v ứ c
gi	g i
dẳng	d ẳ n g
lún	l ú n
cút	c ú t
cuồn	c u ồ n
kỉ	k ỉ
đanh	đ a n h
vít	v í t
rành	r à n h
bịp	b ị p
bự	b ự
chĩa	c h ĩ a
tì	t ì
úp	ú p
nô	n ô
ngửi	n g ử i
trìu	t r ì u
toại	t o ạ i
sá	s á
nhoi	n h o i
nhìu	n h ì u
lằng	l ằ n g
nhằng	n h ằ n g
dượt	d ư ợ t
trặc	t r ặ c
dìm	d ì m
lòe	l ò e
loẹt	l o ẹ t
yểm	y ể m
beo	b e o
đoái	đ o á i
chùng	c h ù n g
oải	o ả i
víu	v í u
vòm	v ò m
ngùn	n g ù n
ngụt	n g ụ t
noi	n o i
phổng	p h ổ n g
xuyến	x u y ế n
nhện	n h ệ n
nhím	n h í m
am	a m
vắn	v ắ n
thớ	t h ớ
loáng	l o á n g
quện	q u ệ n
nặn	n ặ n
giò	g i ò
quất	q u ấ t
viếng	v i ế n g
đấm	đ ấ m
vuốt	v u ố t
nịch	n ị c h
adn	a d n
bưu	b ư u
phàm	p h à m
lân	l â n
ngụm	n g ụ m
khanh	k h a n h
ghẽ	g h ẽ
xèo	x è o
chèo	c h è o
vùi	v ù i
chuồn	c h u ồ n
kén	k é n
nhen	n h e n
xém	x é m
cầy	c ầ y
vầng	v ầ n g
ang	a n g
áng	á n g
sồi	s ồ i
thung	t h u n g
lủng	l ủ n g
ngoặt	n g o ặ t
cau	c a u
thũng	t h ũ n g
khiêng	k h i ê n g
tưng	t ư n g
tửng	t ử n g
ngạt	n g ạ t
ó	ó
sòng	s ò n g
rầu	r ầ u
trảng	t r ả n g
báu	b á u
hòng	h ò n g
gội	g ộ i
bin	b i n
đán	đ á n
nhòe	n h ò e
đicr	đ i c r
lỉnh	l ỉ n h
khỉnh	k h ỉ n h
chuông	c h u ô n g
lèo	l è o
chích	c h í c h
rông	r ô n g
lõng	l õ n g
vợi	v ợ i
chôm	c h ô m
bưng	b ư n g
môt	m ô t
húc	h ú c
rìu	r ì u
rạo	r ạ o
nẹp	n ẹ p
chòm	c h ò m
sam	s a m
sọc	s ọ c
sấm	s ấ m
lốc	l ố c
xoáy	x o á y
mướn	m ư ớ n
vơ	v ơ
bịu	b ị u
lẻn	l ẻ n
lợ	l ợ
thuôn	t h u ô n
bạ	b ạ
dẹt	d ẹ t
nác	n á c
dơ	d ơ
rạc	r ạ c
đới	đ ớ i
toản	t o ả n
bủa	b ủ a
răn	r ă n
huyên	h u y ê n
tĩu	t ĩ u
giêng	g i ê n g
vắt	v ắ t
nhậm	n h ậ m
hạo	h ạ o
xóc	x ó c
nhừ	n h ừ
ben	b e n
oánh	o á n h
mu	m u
cộ	c ộ
thẫm	t h ẫ m
giở	g i ở
vã	v ã
cúp	c ú p
ghim	g h i m
sim	s i m
qúy	q ú y
hờ	h ờ
ghe	g h e
hến	h ế n
lách	l á c h
xiên	x i ê n
tivi	t i v i
mánh	m á n h
khoé	k h o é
bo	b o
nhơ	n h ơ
đigiúp	đ i g i ú p
lạp	l ạ p
mười	m ư ờ i
rã	r ã
mấu	m ấ u
pơ	p ơ
vồng	v ồ n g
rơ	r ơ
khỉ	k h ỉ
nhót	n h ó t
nhàu	n h à u
uổng	u ổ n g
mươi	m ư ơ i
tám	t á m
rùa	r ù a
chéo	c h é o
đáu	đ á u
rậm	r ậ m
xổ	x ổ
thó	t h ó
ráng	r á n g
chợt	c h ợ t
chửa	c h ử a
gởi	g ở i
bẹp	b ẹ p
ươn	ư ơ n
búi	b ú i
kìa	k ì a
khmer	k h m e r
mầu	m ầ u
ngút	n g ú t
xú	x ú
uế	u ế
rích	r í c h
mận	m ậ n
chát	c h á t
ất	ấ t
quí	q u í
khoanh	k h o a n h
rặn	r ặ n
đét	đ é t
lùm	l ù m
xùm	x ù m
veo	v e o
ló	l ó
uyên	u y ê n
quậy	q u ậ y
nẻo	n ẻ o
cụt	c ụ t
vò	v ò
vãng	v ã n g
dỡ	d ỡ
ngai	n g a i
bập	b ậ p
lỵ	l ỵ
hằn	h ằ n
lã	l ã
nhộng	n h ộ n g
nhích	n h í c h
gờm	g ờ m
khước	k h ư ớ c
bẹn	b ẹ n
hòm	h ò m
bún	b ú n
rưng	r ư n g
uyển	u y ể n
ngóc	n g ó c
s	s
nhấc	n h ấ c
túa	t ú a
bặt	b ặ t
cày	c à y
vồn	v ồ n
bu	b u
góa	g ó a
đìu	đ ì u
hiu	h i u
banh	b a n h
giỡn	g i ỡ n
đủng	đ ủ n g
vung	v u n g
trồ	t r ồ
nghẹt	n g h ẹ t
hoen	h o e n
gỉ	g ỉ
rết	r ế t
thằn	t h ằ n
lằn	l ằ n
hâu	h â u
mế	m ế
bun	b u n
chớp	c h ớ p
tiếu	t i ế u
rận	r ậ n
gở	g ở
quệt	q u ệ t
bẽ	b ẽ
quặc	q u ặ c
tròng	t r ò n g
gàu	g à u
phuy	p h u y
đủi	đ ủ i
đốn	đ ố n
huân	h u â n
nơm	n ơ m
nớp	n ớ p
vạc	v ạ c
rởm	r ở m
hoả	h o ả
vệt	v ệ t
xẻng	x ẻ n g
rạ	r ạ
láo	l á o
hoạn	h o ạ n
vữa	v ữ a
nguyền	n g u y ề n
ngỗng	n g ỗ n g
gắp	g ắ p
rô	r ô
dãi	d ã i
loay	l o a y
hoay	h o a y
chỏng	c h ỏ n g
chơ	c h ơ
muôi	m u ô i
duỗi	d u ỗ i
lỏi	l ỏ i
xõa	x õ a
lỏm	l ỏ m
choàng	c h o à n g
cốm	c ố m
thúng	t h ú n g
sính	s í n h
miệt	m i ệ t
vát	v á t
rưới	r ư ớ i
quầy	q u ầ y
dìu	d ì u
khuấy	k h u ấ y
đềm	đ ề m
chun	c h u n
thím	t h í m
vừng	v ừ n g
tặc	t ặ c
nháy	n h á y
chốc	c h ố c
gấc	g ấ c
nham	n h a m
núp	n ú p
sà	s à
hực	h ự c
then	t h e n
tr	t r
dũ	d ũ
chôn	c h ô n
đằm	đ ằ m
au	a u
xiêu	x i ê u
hù	h ù
bầm	b ầ m
ăng	ă n g
liếm	l i ế m
ắt	ắ t
oăm	o ă m
tếu	t ế u
múc	m ú c
thưa	t h ư a
vắc	v ắ c
toác	t o á c
nhấm	n h ấ m
nháp	n h á p
đổng	đ ổ n g
ngấy	n g ấ y
han	h a n
nghẽn	n g h ẽ n
vồ	v ồ
chửng	c h ử n g
hùm	h ù m
ngời	n g ờ i
câm	c â m
gieo	g i e o
xỏ	x ỏ
chắp	c h ắ p
vênh	v ê n h
bở	b ở
méo	m é o
mó	m ó
bõm	b õ m
kạn	k ạ n
cỏi	c ỏ i
găm	g ă m
lẽo	l ẽ o
ghiền	g h i ề n
khứa	k h ứ a
líu	l í u
ắc	ắ c
kị	k ị
chành	c h à n h
ha	h a
nhẩm	n h ẩ m
moi	m o i
đận	đ ậ n
ngộp	n g ộ p
loai	l o a i
bảnh	b ả n h
hột	h ộ t
tút	t ú t
hẻm	h ẻ m
chèn	c h è n
toái	t o á i
hậm	h ậ m
sê	s ê
ới	ớ i
rộp	r ộ p
nựng	n ự n g
quyển	q u y ể n
trỏ	t r ỏ
xói	x ó i
nồm	n ồ m
tráo	t r á o
nín	n í n
nãy	n ã y
xỉa	x ỉ a
giễu	g i ễ u
cợt	c ợ t
tớ	t ớ
chon	c h o n
thong	t h o n g
gặm	g ặ m
mép	m é p
kháu	k h á u
dẻ	d ẻ
càn	c à n
ì	ì
còng	c ò n g
day	d a y
bả	b ả
ru	r u
nóc	n ó c
bìa	b ì a
giếm	g i ế m
nhỏm	n h ỏ m
cứa	c ứ a
vố	v ố
chác	c h á c
ngụ	n g ụ
khựng	k h ự n g
choi	c h o i
đản	đ ả n
quặt	q u ặ t
thính	t h í n h
lạy	l ạ y
ríu	r í u
ối	ố i
nghê	n g h ê
dậu	d ậ u
bìu	b ì u
hùa	h ù a
bét	b é t
hú	h ú
hĩnh	h ĩ n h
tuột	t u ộ t
lọi	l ọ i
nhe	n h e
dứa	d ứ a
hom	h o m
mề	m ề
đay	đ a y
nguỵ	n g u ỵ
tuốt	t u ố t
ỉm	ỉ m
sô	s ô
oán	o á n
q	q
bậy	b ậ y
mứt	m ứ t
lia	l i a
cạc	c ạ c
nít	n í t
lủi	l ủ i
két	k é t
chẻ	c h ẻ
địu	đ ị u
thán	t h á n
nịnh	n ị n h
nọt	n ọ t
dấy	d ấ y
lể	l ể
ừ	ừ
kẽ	k ẽ
sộ	s ộ
rọi	r ọ i
cộp	c ộ p
bìm	b ì m
xôi	x ô i
trau	t r a u
nệm	n ệ m
khất	k h ấ t
mia	m i a
coca	c o c a
lả	l ả
tăn	t ă n
tề	t ề
phay	p h a y
khuông	k h u ô n g
ứ	ứ
nớt	n ớ t
vế	v ế
tâng	t â n g
sứa	s ứ a
móm	m ó m
hẫng	h ẫ n g
gạ	g ạ
ke	k e
ình	ì n h
cũn	c ũ n
cỡn	c ỡ n
dực	d ự c
dũa	d ũ a
dòi	d ò i
lết	l ế t
xâu	x â u
rủng	r ủ n g
rỉnh	r ỉ n h
bệ	b ệ
kiệu	k i ệ u
nghiễm	n g h i ễ m
chằm	c h ằ m
ngoãn	n g o ã n
trằn	t r ằ n
nhựt	n h ự t
lòi	l ò i
thiu	t h i u
khảnh	k h ả n h
lùn	l ù n
nòi	n ò i
iu	i u
trọi	t r ọ i
vẩy	v ẩ y
sồ	s ồ
sề	s ề
trui	t r u i
bêu	b ê u
kèn	k è n
sắn	s ắ n
chuốc	c h u ố c
củi	c ủ i
cối	c ố i
ổng	ổ n g
ảm	ả m
rưỡi	r ư ỡ i
răm	r ă m
ươm	ư ơ m
te	t e
hốc	h ố c
đóa	đ ó a
ẵm	ẵ m
nhản	n h ả n
quệ	q u ệ
chạc	c h ạ c
ngợp	n g ợ p
ngòi	n g ò i
giâm	g i â m
nghiến	n g h i ế n
lù	l ù
khàn	k h à n
ngoắt	n g o ắ t
cụp	c ụ p
pi	p i
liếng	l i ế n g
dỏm	d ỏ m
xuê	x u ê
xhcn	x h c n
sũng	s ũ n g
trệ	t r ệ
chếch	c h ế c h
đờm	đ ờ m
dơi	d ơ i
vái	v á i
phộng	p h ộ n g
hì	h ì
ớn	ớ n
lùa	l ù a
lít	l í t
bổn	b ổ n
òa	ò a
hói	h ó i
lợp	l ợ p
lịm	l ị m
hửng	h ử n g
nhum	n h u m
ngáo	n g á o
nép	n é p
quỵt	q u ỵ t
nhão	n h ã o
khạc	k h ạ c
xoan	x o a n
rét	r é t
nhọ	n h ọ
bẽo	b ẽ o
úng	ú n g
ươi	ư ơ i
mửa	m ử a
chư	c h ư
thình	t h ì n h
sào	s à o
vót	v ó t
rợp	r ợ p
uẩn	u ẩ n
ghì	g h ì
rói	r ó i
dẽ	d ẽ
lảng	l ả n g
loang	l o a n g
sục	s ụ c
xổm	x ổ m
bòng	b ò n g
tuồn	t u ồ n
thới	t h ớ i
khèn	k h è n
véo	v é o
ú	ú
ụ	ụ
phin	p h i n
phơ	p h ơ
lúng	l ú n g
phèo	p h è o
rắp	r ắ p
ngò	n g ò
phung	p h u n g
tốp	t ố p
nhẹt	n h ẹ t
dẫm	d ẫ m
rót	r ó t
mân	m â n
casino	c a s i n o
tom	t o m
vánh	v á n h
chầm	c h ầ m
rợn	r ợ n
chông	c h ô n g
gợn	g ợ n
lụng	l ụ n g
pen	p e n
miếu	m i ế u
rải	r ả i
xoàng	x o à n g
him	h i m
túp	t ú p
trãi	t r ã i
bâu	b â u
nán	n á n
giầu	g i ầ u
dởm	d ở m
trẽn	t r ẽ n
sưa	s ư a
vẹo	v ẹ o
kềnh	k ề n h
phào	p h à o
tót	t ó t
hợi	h ợ i
thăn	t h ă n
rú	r ú
khuân	k h u â n
ngót	n g ó t
guitar	g u i t a r
tặn	t ặ n
buồm	b u ồ m
nọc	n ọ c
lạng	l ạ n g
căm	c ă m
thây	t h â y
gọng	g ọ n g
kỉnh	k ỉ n h
luẩn	l u ẩ n
ròng	r ò n g
hỉnh	h ỉ n h
lặt	l ặ t
ứa	ứ a
xập	x ậ p
gành	g à n h
ná	n á
duật	d u ậ t
hạc	h ạ c
ghẹo	g h ẹ o
luyn	l u y n
búng	b ú n g
tụi	t ụ i
lẳng	l ẳ n g
kháo	k h á o
tảo	t ả o
bôn	b ô n
dái	d á i
vối	v ố i
rổ	r ổ
chóc	c h ó c
bốt	b ố t
cơi	c ơ i
diêm	d i ê m
tuồng	t u ồ n g
ken	k e n
phảng	p h ả n g
rệu	r ệ u
thuỳ	t h u ỳ
mạp	m ạ p
bấc	b ấ c
sex	s e x
tòi	t ò i
vụt	v ụ t
thêu	t h ê u
rầy	r ầ y
nanh	n a n h
thảy	t h ả y
ệ	ệ
quẳng	q u ẳ n g
híp	h í p
thoạt	t h o ạ t
cắc	c ắ c
gồ	g ồ
ghề	g h ề
thết	t h ế t
rim	r i m
nhuần	n h u ầ n
phầm	p h ầ m
sắng	s ắ n g
tràm	t r à m
sám	s á m
tạc	t ạ c
hinh	h i n h
nem	n e m
hững	h ữ n g
xúy	x ú y
nấp	n ấ p
thụt	t h ụ t
đờn	đ ờ n
lim	l i m
nhổm	n h ổ m
nhúm	n h ú m
nua	n u a
mỏm	m ỏ m
khấm	k h ấ m
ùng	ù n g
ọp	ọ p
ẹp	ẹ p
trườn	t r ư ờ n
nấng	n ấ n g
quẹt	q u ẹ t
hớt	h ớ t
rìa	r ì a
truồng	t r u ồ n g
hóng	h ó n g
hớn	h ớ n
hiềm	h i ề m
thếp	t h ế p
giẻ	g i ẻ
ngưởng	n g ư ở n g
ki	k i
ốt	ố t
xiêm	x i ê m
giăng	g i ă n g
biền	b i ề n
nẩy	n ẩ y
mênh	m ê n h
gáo	g á o
hăm	h ă m
ngạo	n g ạ o
ad	a d
rần	r ầ n
huyễn	h u y ễ n
tủa	t ủ a
tòng	t ò n g
bâng	b â n g
khuâng	k h u â n g
thâu	t h â u
xoạc	x o ạ c
thuấn	t h u ấ n
xéo	x é o
nuột	n u ộ t
mơn	m ơ n
giàng	g i à n g
dom	d o m
hạp	h ạ p
dằng	d ằ n g
dặc	d ặ c
triền	t r i ề n
chụm	c h ụ m
khểnh	k h ể n h
ngoặc	n g o ặ c
thớt	t h ớ t
choang	c h o a n g
điếm	đ i ế m
dà	d à
cún	c ú n
trỉa	t r ỉ a
đom	đ o m
đóm	đ ó m
phèn	p h è n
oxi	o x i
nhúc	n h ú c
quơ	q u ơ
trẩy	t r ẩ y
toa	t o a
bèn	b è n
nhòm	n h ò m
ngó	n g ó
xếch	x ế c h
giê	g i ê
guồng	g u ồ n g
gả	g ả
sụa	s ụ a
lum	l u m
khờ	k h ờ
lú	l ú
tiệp	t i ệ p
cạy	c ạ y
ọe	ọ e
lũng	l ũ n g
nhử	n h ử
đớp	đ ớ p
róc	r ó c
ké	k é
mợ	m ợ
phình	p h ì n h
rằn	r ằ n
khua	k h u a
lừ	l ừ
thỏm	t h ỏ m
radio	r a d i o
khấp	k h ấ p
oằn	o ằ n
si	s i
choán	c h o á n
quáng	q u á n g
quằn	q u ằ n
quại	q u ạ i
sái	s á i
hóp	h ó p
tột	t ộ t
khóm	k h ó m
đơm	đ ơ m
lắt	l ắ t
dặt	d ặ t
nái	n á i
gông	g ô n g
cùm	c ù m
bĩ	b ĩ
von	v o n
vãnh	v ã n h
bươu	b ư ơ u
bụp	b ụ p
xẹp	x ẹ p
thinh	t h i n h
rớm	r ớ m
ku	k u
nhoà	n h o à
tược	t ư ợ c
um	u m
nhứt	n h ứ t
nhỉnh	n h ỉ n h
xo	x o
gộc	g ộ c
chét	c h é t
dật	d ậ t
són	s ó n
sền	s ề n
nhuệ	n h u ệ
riu	r i u
sậm	s ậ m
bẹ	b ẹ
trá	t r á
chuốt	c h u ố t
chình	c h ì n h
giẫm	g i ẫ m
đẵng	đ ẵ n g
liềm	l i ề m
rai	r a i
xị	x ị
luy	l u y
hẩu	h ẩ u
lốn	l ố n
vông	v ô n g
thào	t h à o
don	d o n
trứ	t r ứ
tuýt	t u ý t
chưởng	c h ư ở n g
quẫn	q u ẫ n
nhoài	n h o à i
tậm	t ậ m
rúng	r ú n g
sệ	s ệ